"3125","7334"
"3125","7335"
"3125","7336"
"3125","7337"
"3125","7338"
"3125","7339"
"3125","7340"
"3125","7341"
"3125","7343"
"3125","7344"
"3125","7345"
"3125","7347"
"3125","7353"
"3125","7355"
"3125","7359"
"3125","7360"
"3125","7361"
"3125","7362"
"3125","7363"
"3125","7365"
"3125","7366"
"3125","7367"
"3125","7368"
"3125","7370"
"3125","7371"
"3125","7372"
"3125","7373"
"3125","7374"
"3125","7377"
"3125","7379"
"3125","7380"
"3125","7381"
"3125","7382"
"3125","7383"
"3125","7384"
"3125","7385"
"3125","7386"
"3125","7387"
"3125","7389"
"3125","7390"
"3125","7391"
"3125","7392"
"3125","7393"
"3125","7487"
"3125","7488"
"3125","7489"
"3125","7490"
"3125","7492"
"3125","7494"
"3125","7496"
"3125","7508"
"3125","7510"
"3125","7520"
"3125","7522"
"3125","7569"
"3125","7616"
"3125","7736"
"3125","7737"
"3125","7833"
"3125","7837"
"3125","7846"
"3125","7851"
"3125","7860"
"3125","7861"
"3125","8074"
"3125","8076"
"3125","8080"
"3125","8081"
"3125","8089"
"3125","8090"
"3125","8091"
"3125","8092"
"3125","8093"
"3125","8109"
"3125","8111"
"3125","8112"
"3125","8113"
"3125","8114"
"3125","8115"
"3125","8116"
"3125","8137"
"3125","8138"
"3125","8140"
"3125","8147"
"3125","8206"
"3125","8208"
"3125","8238"
"3125","8243"
"3125","8246"
"3125","8255"
"3125","8256"
"3125","8258"
"3125","8259"
"3125","8301"
"3125","8302"
"3125","8304"
"3125","8305"
"3125","8306"
"3125","8308"
"3125","8309"
"3125","8326"
"3125","8327"
"3125","8328"
"3125","8339"
"3125","8346"
"3125","8347"
"3125","8368"
"3125","8383"
"3125","8398"
"3125","8400"
"3125","8403"
"3125","8483"
"3125","8484"
"3125","8485"
"3125","8486"
"3125","8487"
"3125","8488"
"3125","8489"
"3125","8490"
"3125","8491"
"3125","8492"
"3125","8493"
"3125","8494"
"3125","8495"
"3125","8497"
"3125","8498"
"3125","8499"
"3125","8500"
"3125","8501"
"3125","8502"
"3125","8503"
"3125","8504"
"3125","8505"
"3125","8506"
"3125","8507"
"3125","8508"
"3125","8509"
"3125","8510"
"3125","8511"
"3125","8512"
"3125","8513"
"3125","8514"
"3125","8515"
"3125","8516"
"3125","8517"
"3125","8518"
"3125","8519"
"3125","8520"
"3125","8521"
"3125","8522"
"3125","8523"
"3125","8524"
"3125","8525"
"3125","8526"
"3125","8527"
"3125","8528"
"3125","8529"
"3125","8530"
"3125","8531"
"3125","8532"
"3125","8533"
"3125","8534"
"3125","8535"
"3125","8536"
"3125","8537"
"3125","8538"
"3125","8539"
"3125","8541"
"3125","8542"
"3125","8543"
"3125","8544"
"3125","8611"
"3125","8612"
"3125","8613"
"3125","8614"
"3125","8615"
"3125","8637"
"3125","8639"
"3125","8642"
"3125","8643"
"3125","8644"
"3125","8646"
"3125","8667"
"3125","8691"
"3125","8692"
"3125","8693"
"3125","8702"
"3125","8709"
"3125","8711"
"3125","8712"
"3125","8713"
"3125","8749"
"3125","8807"
"3125","8826"
"3125","8835"
"3125","8849"
"3125","8850"
"3125","8853"
"3125","8962"
"3125","8967"
"3125","9012"
"3125","9047"
"3125","9048"
"3125","9108"
"3125","9236"
"3125","9252"
"3125","9255"
"3125","9256"
"3125","9262"
"3125","9264"
"3125","9267"
"3125","9288"
"3125","9292"
"3125","9303"
"3125","9304"
"3125","9306"
"3125","9309"
"3125","9312"
"3125","9317"
"3125","9335"
"3125","9336"
"3125","9345"
"3125","9346"
"3125","9367"
"3125","9371"
"3125","9372"
"3125","9412"
"3125","9466"
"3125","9479"
"3125","9564"
"3125","9565"
"3125","9566"
"3125","9579"
"3125","9600"
"3125","9631"
"3125","9636"
"3125","9641"
"3125","9643"
"3125","9644"
"3125","9645"
"3125","9647"
"3125","9649"
"3125","9650"
"3125","9652"
"3125","9654"
"3125","9656"
"3125","9657"
"3125","9658"
"3125","9659"
"3125","9661"
"3125","9700"
"3125","9717"
"3125","9726"
"3125","9729"
"3125","9838"
"3125","9839"
"3125","9840"
"3125","10054"
"3125","10056"
"3125","10059"
"3125","10067"
"3125","10110"
"3125","10133"
"3125","10138"
"3125","10147"
"3125","10167"
"3125","10171"
"3125","10186"
"3125","10187"
"3125","10188"
"3125","10189"
"3125","10230"
"3125","10231"
"3125","10232"
"3125","10233"
"3125","10234"
"3125","10235"
"3125","10236"
"3125","10237"
"3125","10262"
"3125","10287"
"3125","10304"
"3125","10306"
"3125","10307"
"3125","10335"
"3125","10351"
"3125","10367"
"3125","10368"
"3125","10382"
"3125","10384"
"3125","10423"
"3125","10462"
"3125","10472"
"3125","10539"
"3125","10554"
"3125","10576"
"3125","10586"
"3125","10592"
"3125","10593"
"3125","10624"
"3125","10625"
"3125","10692"
"3125","10703"
"3125","10712"
"3125","10735"
"3125","10747"
"3125","10748"
"3125","10749"
"3125","10765"
"3125","10766"
"3125","10768"
"3125","10769"
"3125","10914"
"3125","10915"
"3125","10916"
"3125","10917"
"3125","10918"
"3125","10919"
"3125","10922"
"3125","10924"
"3125","10925"
"3125","10956"
"3125","10958"
"3125","10959"
"3125","10979"
"3125","11011"
"3125","11012"
"3125","11013"
"3125","11014"
"3125","11015"
"3125","11016"
"3125","11025"
"3125","11026"
"3125","11043"
"3125","11045"
"3125","11057"
"3125","11058"
"3125","11059"
"3125","11060"
"3125","11061"
"3125","11099"
"3125","11124"
"3125","11125"
"3125","11126"
"3125","11130"
"3125","11153"
"3125","11154"
"3125","11156"
"3125","11160"
"3125","11161"
"3125","11175"
"3125","11177"
"3125","11179"
"3125","11180"
"3125","11182"
"3125","11183"
"3125","11184"
"3125","11188"
"3125","11189"
"3125","11190"
"3125","11198"
"3125","11199"
"3125","11200"
"3125","11201"
"3125","11205"
"3125","11207"
"3125","11208"
"3125","11210"
"3125","11211"
"3125","11212"
"3125","11214"
"3125","11215"
"3125","11216"
"3125","11217"
"3125","11218"
"3125","11219"
"3125","11221"
"3125","11230"
"3125","11231"
